..........
.S------7.
.|F----7|.
.||OOOO||.
.||OOOO||.
.|L-7F-J|.
.|II||II|.
.L--JL--J.
..........

